1111111111111
10010000C0001
10P0011111001
100011000E001
1111111111111
