1111111111111
1001000000C01
10P0011111001
100011000E001
1111111111111
