1111111111
100000E001
100CP00001
1000000001
1000000001
1000000001
1000000001
1111111111