1111111111111
1E110P00000C1
1110011111111
100000C000001
1111111111111
