1111111111111111111111111111111111
100E000P0000000C00000C000000000001
1111111111111111111111111111111111
