1111111111111111111111111111111111
1000000P0000E00C00000C000000000001
1111111111111111111111111111111111
