1111111111111
1EC10C00000C1
1000011111001
1P0011C000001
1111111111111