111111111111111111111111111111111111111
1P00011000C000000000000111110C100000001
11000110000000000110000000C000011110C01
11000000000001111110C000011E00000000001
1C000111100000000000000000000000C000111
100C1111111111111111111C00000000000C111
111111111111111111111111111111111111111
