1111111111111
1EC10000000C1
10P0011111111
100000C000001
1111111111111
