1111111111111
1EC10000001C1
10P0011111111
100011C000001
1111111111111
