1111111111111
1EC10000000C1
1000011111001
100011C000001
10C10000000C1
1000011111001
100011C000001
10C10000000C1
1000011111001
100011C000001
10C10000000C1
10P0011111001
100011C000001
10C10000000C1
1000011111001
100011C000001
100011C000001
10C10000000C1
1000011111001
1111111111111