1111111111111
1EC1000000C01
10P0011111001
100011C000001
1111111111111
